scaffold_1	reverse	TAGCTACTAGATAACCCTGGCCGAGGGTTAGGGTTAGGGTTAGGGTTAGGGTTAGGGTTAGGGTTAGGGTTAGGGTTAGGGTTAGGGTTAGGGTTAGGGT
scaffold_5	forward	AATAAGACTTCTTTATATTAATAAGCCTAATAAGTATTACTTAATTATTAAGAGATATAATAACTAACTTACTTAATATAATACCTTATATATTCTGTAA
scaffold_6	reverse	TAAGATAAATATATATATCTAAAAGGGTTAGGGTTAGGGTTAGGGTTAGGGTTAGGGTTAGGGTTAGGGTTAGGGTTAGGGTTAGGGTTAGGGTTAGGGT
scaffold_8	forward	TAGCTAGATCTTAGTTAGAGAAAAACACCAGGGCAAAGATAGCTTAGATAGTTAATACTAACCCTATCCTAACCCTAACCCTAATTAAAGAGGATAGTAA
scaffold_9	forward	ATCTTAGTTAGAGAAAAACACCAGGGCAAAGATAGCTTAGATAGTTAATACTAACCCTATCCTAACCCTAACCCTAAGAAAACAAGGAACTCTCGCAATT
scaffold_10	forward	ATCTTAGTTAGAGAAAAACACCAGGGCAAAGATAGCTTAGATAGTTAATACTAACCCTATCCTAACCCTAACCCTAACCCGGACCCTAACCCTAAGTTGA
scaffold_13	forward	CCCTAACCCTAACCCTAACCCTAACCCTAACCCTAACCCTAACCCTAACCCTAACCCTAACCCTAACCCTAACCCTAAGAATGTTGAGCTCTTTGCATAG
scaffold_15	forward	CTAACCCTAACCCTAACCCTAACCCTAACCCTAACCCTAACCCTAACCCTAACCCTAACCCTAACCCTAACCCTAAGGGTGTCTGGAGACGATCTCATTA
scaffold_17	reverse	ATAAAACTACTACCAGATAAAAGCTTAGGGTTAGGGTTAGGGTTAGGGTTAGGGTTAGGGTTAGGGTTAGGGTTAGGGTTAGGGTTAGGGTTAGGGTTAG
scaffold_23	forward	CCTAACCCTAACCCTAACCCTAACCCTAACCCTAACCCTAACCCTAACCCTAACCCTAACCCTAACCCTAACCCTAGACCCTATAGGCCTTAAAGACCTC
scaffold_25	reverse	AAGCTGGCAGTCTCTATTTCAGATTAGGGTTAGGGTTAGGGTTAGGGTTAGGGTTAGGGTTAGGGTTAGGGTTAGGGTTAGGGTTAGGGTTAGGGTTAGG
scaffold_27	reverse	GTACTATTTCTATTACTTAGATAGTTAGGGTTAGGGTTAGGGTTAGGGTTAGGGTTAGGGTTAGGGTTAGGGTTAGGGTTAGGGTTAGGGTTAGGGTTAG
scaffold_33	forward	CTAACCCTAACCCTAACCCTAACCCTAACCCTAACCCTAACCCTAACCCTAACCCTAACCCTAACCCTAACCCTAATTTTCAAAATTTTTAAACCCTTAC
scaffold_34	forward	CTAACCCTAACCCTAACCCTAACCCTAACCCTAACCCTAACCCTAACCCTAACCCTAACCCTAACCCTAACCCTAAGTTAGACTGGGTATTCGGCATTAT
scaffold_37	reverse	TACTCGATCGCCTCGCTGTGCAACCTTAGGGTTAGGGTTAGGGTTAGGGTTAGGGTTAGGGTTAGGGTTAGGGTTAGGGTTAGGGTTAGGGTTAGGGTTA
scaffold_40	forward	TAACCCTAACCCTAACCCTAACCCTAACCCTAACCCTAACCCTAACCCTAACCCTAACCCTAACCCTAACCCTAAGTAGGGATATTATTTAATATAGTAT
scaffold_41	forward	CTAACCCTAACCCTAACCCTAACCCTAACCCTAACCCTAACCCTAACCCTAACCCTAACCCTAACCCTAACCCTAGCGCCTATATATGCTAACTTTGATG
scaffold_42	reverse	ATACTTAGGCGCCTTTTTTAGGGTTAGGGTTAGGGTTAGGGTTAGGGTTAGGGTTAGGGTTAGGGTTAGGGTTAGGGTTAGGGTTAGGGTTAGGGTTAGG
scaffold_47	forward	CCTAACCCTAACCCTAACCCTAACCCTAACCCTAACCCTAACCCTAACCCTAACCCTAACCCTAACCCTAAGTTAGAGGTTAAGTTAGGCTTAAGGTTAG
scaffold_52	forward	AACCCTAACCCTAACCCTAACCCTAACCCTAACCCTAACCCTAACCCTAACCCTAACCCTAACCCTAACCCTAACCCGGACCCTAACCCAACGTCTGACC
scaffold_58	reverse	TTTATATTAGGCATAGTTTATAAAGTTAAAATATATAGTTAAGTTAGTTAAATTAATAGTATAAATATTCTATTATAAGAATTAAGGGCTATTATAGGGT
scaffold_61	reverse	GCCTTTTAATTATATAGTAGTCCTTTGGGTTAGGGTTAGGGTTAGGGTTAGGGTTAGGGTTAGGGTTAGGGTTAGGGTTAGGGTTAGGGTTAGGGTTAGG

Telomeres found: 22 (13 forward, 9 reverse)
