tig00000036_pilon_pilon_pilon_pilon_pilon	forward	CTAACCCTAACCCTAACCTAACCCTAACCCTAACCCTAACCCTAACCCTAACCCTAACCCTAACCCTAACCCTAACCCTAACCCTAACCCTAACCCTAAC
tig00000057_pilon_pilon_pilon_pilon_pilon	reverse	AGGGTTGGGGGTTAGGGTTAGGGTTAGGGTTAGGGTTAGGGTTAGGGTTAGGGTTAGGGTTAGGGTTAGGGTTAGGGTTAGGGTTAGGGTTAGGGTTAGG
tig00000009_pilon_pilon_pilon_pilon_pilon	forward	TAACCCTAACCCTAACCCTAACCCTAACCCTAACCCTAACCCTAACCCTAACCCTAACCCTAACCCTAACCCTAACCCTAACTTGGACTCGGACTCCTCG
tig00000007_pilon_pilon_pilon_pilon_pilon	forward	AACCTAACCCTAACCTCCCCTAACCCTAACCCTAACCCTAACCCTAACCTAACCCTAACCCTAACCCTAACCCTGACCCTAACCCTAACCCTAACCCTAA
tig00000038_pilon_pilon_pilon_pilon_pilon	forward	CTAACCCTAACCCTAACCTAACCCTAACCCTAACCCTAACCCTAACCCTAACCCTAACCCTAACCCTAACCCTAACCCTAACCCTAACCCTAACCCTAAC
tig00000032_pilon_pilon_pilon_pilon_pilon	forward	CCTAACCCTAACCCCTAACCCTAACCCTAACCCTAACCCTAACCCTAACCCTAACCCTAACCCTAACCCTAACCCTAACCCTAACCCTAACCCTAACCCT
tig00000182_pilon_pilon_pilon_pilon_pilon	forward	ACCTAACCTAACCCTAACCCTAACCCTAACCCTAACCCTAACCCTAACCCTAACCCTAACCCTAACCCTAACCCTAACCCTAACCCTAACCCTAACCCTA
tig00000001_pilon_pilon_pilon_pilon_pilon	forward	TAACCCTAACCCTAACCCTAACCCTAACCCTAACCCTAACCCTAACCCTAACCCTAACCCTAACCCTAACCCTAACCCTAACCCTAACCCTAACCCTAAC
tig00000053_pilon_pilon_pilon_pilon_pilon	forward	AACCCCAACCCTCTAACCCTAACCCTAACCCTAACCCTAACCCTAACCCTAACCCTAACCCTAACCCTAACCCTAACCCTAACCCTAACCCTAACCCTAA
tig00000013_pilon_pilon_pilon_pilon_pilon	forward	CCTAACCCTAACCCTAACCCTAACCCTAACCCTAACCCTAACCCTAACCCTAACCCCTAACCCTAACCCTAACCCTAACCCTAACCCTAACCCTAACCCT
tig00000022_pilon_pilon_pilon_pilon_pilon	reverse	AGGCAGTATTAATACTAGCTCTTAGCAGTTAGGTTACCCTTCTTCCTTTATCCTACCTAAAGGAATACTATGCCTAATTATTTATTATAAAGTATATTCC
tig00000002_pilon_pilon_pilon_pilon_pilon	forward	CCTAACCCTAACCCTAACCCTAACCCTAACCCTAACCTAACCCTAACCCTAACCCTAACCCTAACCCTAACCCTAACCCTAACCCTAACCCTAACCCTAA
tig00000027_pilon_pilon_pilon_pilon_pilon	reverse	GGTTAGGGTTAGGGTTAGGGTTAGGGTTAGGGTTAGGGTTAGGGTTAGGGTTAGGGTTAGGGTTAGGGTTAGGGTTAGGGTTAGGGTTTGGGTTAGGGTT
tig00000008_pilon_pilon_pilon_pilon_pilon	reverse	TAGGGTTAGGGTTAGGGTTAGGGTTAGGGTTAGGGTTAGGGTTAGGGTTAGGGTTAGGGTTAGGGTTAGGGTTAGGGTTAGGGTTAGGGTTAGGGTTAGG
tig00000010_pilon_pilon_pilon_pilon_pilon	reverse	TAGGGTTAGGGTTAGGGTTAGGGTTAGGGTTAGGGTTAGGGTTAGGGTTAGGGTTAGGGTTAGGGTTAGGGTTAGGGTTAGGGTTAGGGTTAGGGTTAGG
tig00000015_pilon_pilon_pilon_pilon_pilon	forward	CCTAACCCTAACCCTAACCCTAACCCTAACCCTAACCCTAACCCTAACCCTAACCCTAACCCTAACCCTAACCCTAACCCTAACCCTAACCCTAACCCTA
tig00000017_pilon_pilon_pilon_pilon_pilon	forward	AAACCCTAACCCTAACCCTAACCCTAACCCTAACCCTAACCCTAACCCTAACCCTAACCCTAACCCTAACCCTAACCCTAACCCTAACCCTAACCCTAAC
tig00000016_pilon_pilon_pilon_pilon_pilon	reverse	GGGTTAGGGTTAGGGGTTAGGGTTAGGGTTAGGGTTAGGGTTAGGGTTAGGGTTAGGGTTAGGGTTAGGGTTAGGGTTAGGGTTAGGGTTAGGGTTAGGG
tig00000035_pilon_pilon_pilon_pilon_pilon	reverse	TTAGGGTTAGGGTTAGGGTTAGGGTTAGGGTTAGGGTTAGGGTTAGGGTTAGGGTTAGGGTTAGGGTTAGGGTTAGGGTTAGGGTTAGGGTTAGGGTTAG
tig00000047_pilon_pilon_pilon_pilon_pilon	forward	CCTAACCCCTAACCCTAACCCTAACCCTAACCCTAACCCTAACCCTAACCCTAACCCTAACCCTAACCCTAACCCTAACCCTAACCCTAACCCTAACCCT

Telomeres found: 20 (13 forward, 7 reverse)
