scaffold_10	forward	CCTAACCCTAACCCTAACCCTAACCCTAACCCTAACCCTAACCCTAACCCTAACCCTAACCCTAACCCTAACCCTAAGGAATGCCTCTATATAAGCTGCC
scaffold_12	forward	ACCCTAACCCTAACCCTAACCCTAACCCTAACCCTAACCCTAACCCTAACCCTAACCCTAACCCTAACCCTAACCCTTTACTTTATTTCTTTATTTATAT
scaffold_23	reverse	AGGAGATAAAAATAGGAAAGAGATAGGGTTAGGGTTAGGGTTAGGGTTAGGGTTAGGGTTAGGGTTAGGGTTAGGGTTAGGGTTAGGGTTAGGGTTAGGG
scaffold_28	forward	ACCCTAACCCTAACCCTAACCCTAACCCTAACCCTAACCCTAACCCTAACCCTAACCCTAACCCTAACCCTAACCCTGACCCTAACCCTAACCCTTCTAA
scaffold_34	reverse	GGTAGTTCCTGGAGCGTCGTGATCTTAGGGTTAGGGTTAGGGTTAGGGTTAGGGTTAGGGTTAGGGTTAGGGTTAGGGTTAGGGTTAGGGTTAGGGTTAG
scaffold_48	reverse	AGCATAAACTAATGGGCTACCTACTTAGGGTTAGGGTTAGGGTTAGGGTTAGGGTTAGGGTTAGGGTTAGGGTTAGGGTTAGGGTTAGGGTTAGGGTTAG
scaffold_49	reverse	TCAGTCCCGTATTTAAACGCTAATTTAGTTTATCAGATTATCTTAATTTAGGGTTAGGGTTAGGGTTAGGGTTAGGGTTAGGGTTAGGGTTAGGGTTAGG
scaffold_50	forward	CCTAACCCTAACCCCAACCCTAACCCTAACCCTAACCCTAACCCTAACCCTAACCCTAACCCTAACCCTAACCCTAATCACACTGGGGTAAGCCACGTAG
scaffold_56	forward	TAAATCCTTATATAAATAGCACCAGAGCAAGATAGCTATCCATAGCCTAATATAACCCTATCCTAACCCTAACCCTAGTACAACTTTCACATGTTAGCTT
scaffold_65	forward	AACCCTAACCCTAACCCTAACCCTAACCCTAACCCTAACCCTAACCCTAACCCTAACCCTAACCCTAACCCTAATAATATTACCTTTCTTCCTTAACCTT
scaffold_74	forward	TAACCCTAACCCTAACCCTAACCCTAACCCTAACCCTAACCCTAACCCTAACCCTAACCCTAACCCTAACCCTAACCTTAAGGTCAGGGGTTATTTAAAT
scaffold_86	reverse	AAAGGTTAGTCTTTTTAACCTTGTAGGGTTAGGGTTAGGGTTAGGGTTAGGGTTAGGGTTAGGGTTAGGGTTAGGGTTAGGGTTAGGGTTAGGGTTAGGG
scaffold_115	forward	CCCTAACCCTAACCCTAACCCTAACCCTAACCCTAACCCTAACCCTAACCCTAACCCTAACCCTAACCCTAGCCCTAGCCCTAACGCTAACCCTAACCCT
scaffold_134	forward	ACCCTAACCCTAACCCTAACCCTAACCCTAACCCTAACCCTAACCCTAACCCTAACCCTAACCCTGACCCTAACCCTGACCCTAACCCTGACCCAAAGCG
scaffold_138	reverse	AGCGCGGTAGCGCTGGGTTAAGTAAGGGTTAGGGTTAGGGTTAGGGTTAGGGTTAGGGTTAGGGTTAGGGTTAGGGTTAGGGTTAGGGTTAGGGTTAGGG
scaffold_141	forward	TAACCCTAACCCTAACCCTAACCCTAACCCTAACCCTAACCCTAACCCTAACCCTAACCCTAACCCTAACCCTAATCTTTATTTCTTATTATCTCTCTTA
scaffold_142	forward	CTAACCCTAACCCTAACCCTAACCCTAACCCTAACCCTAACCCTAACCCTAACCCTAACCCTAACCCTAACCCTAATAAAGCAGAGAAGTTCCTTAGATA
scaffold_145	reverse	TTACCTATGTGCTTGCTGATCTTATCTTAGGGTTAGGGTTAGGGTTAGGGTTAGGGTTAGGGTTAGGGTTAGGGTTAGGGTTAGGGTTAGGGTTAGGGTT
scaffold_151	reverse	GGCCAGGCAACGGTAATACTTCAGTTAGGGTTAGGGTTAGGGTTAGGGTTAGGGTTAGGGTTAGGGTTAGGGTTAGGGTTAGGGTTAGGGTTAGGGTTAG
scaffold_155	forward	AACCCTAACCCTAACCCTAACCCTAACCCTAACCCTAACCCTAACCCTAACCCTAACCCTAACCCTAACCCTAACCTGGACTCGGACTCGGACTCGGACC

Telomeres found: 20 (12 forward, 8 reverse)
