scaffold_5 Fusarium odoratissimum isolate CF00141	forward	CCTAACCCTAACCCTAACCCTAACCCTAACCCTAACCCTAACCCTAACCCTAACCCTAACCCTAACCCTAACCCTAAGTAGGTAGCCCATTAGTTTATGC
scaffold_6 Fusarium odoratissimum isolate CF00141	reverse	GGCCAGGCAACGGTAATACTTCAGTTAGGGTTAGGGTTAGGGTTAGGGTTAGGGTTAGGGTTAGGGTTAGGGTTAGGGTTAGGGTTAGGGTTAGGGTTAG
scaffold_10 Fusarium odoratissimum isolate CF00141	reverse	AGAAATAAAGTAAAGGGTTAGGGTTAGGGTTAGGGTTAGGGTTAGGGTTAGGGTTAGGGTTAGGGTTAGGGTTAGGGTTAGGGTTAGGGTTAGGGTTAGG
scaffold_37 Fusarium odoratissimum isolate CF00141	forward	CCCTAACCCTAACCCTAACCCTAACCCTAACCCTAACCCTAACCCTAACCCTAACCCTAACCCTAACCCTAACCCTATCTCTTTCCTATTTTTATCTCCT
scaffold_39 Fusarium odoratissimum isolate CF00141	reverse	GGTAGTTCCTGGAGCGTCGTGATCTTAGGGTTAGGGTTAGGGTTAGGGTTAGGGTTAGGGTTAGGGTTAGGGTTAGGGTTAGGGTTAGGGTTAGGGTTAG
scaffold_44 Fusarium odoratissimum isolate CF00141	reverse	ATCTAAGGAACTTCTCTGCTTTATTAGGGTTAGGGTTAGGGTTAGGGTTAGGGTTAGGGTTAGGGTTAGGGTTAGGGTTAGGGTTAGGGTTAGGGTTAGG
scaffold_58 Fusarium odoratissimum isolate CF00141	forward	CTAACCCTAACCCCAACCCTAACCCTAACCCTAACCCTAACCCTAACCCTAACCCTAACCCTAACCCTAACCCTAATCACACTGGGGTAAGCCACGTAGG
scaffold_60 Fusarium odoratissimum isolate CF00141	forward	ATAAATCCTTATATAAATAGCACCTAAGCAAGATAGCTTTCCATAGCCTAATATAACCCTATCCTAACCCTAACCCTAACACAGCTGGTAGAAGTGGCTG
scaffold_66 Fusarium odoratissimum isolate CF00141	forward	AACCCTAACCCTAACCCTAACCCTAACCCTAACCCTAACCCTAACCCTAACCCTAACCCTAACCCTAACCCTAATAATATTACCTTTCTTCCTTAACCTT
scaffold_67 Fusarium odoratissimum isolate CF00141	forward	CCCTAACCCTAACCCTAACCCTAACCCTAACCCTAACCCTAACCCTAACCCTAACCCTAACCCTAACCCTAACCCTACAAGGTTAAAAAGACTAACCTTT
scaffold_76 Fusarium odoratissimum isolate CF00141	reverse	ATTTAAATAACCCCTGACCTTAAGGTTAGGGTTAGGGTTAGGGTTAGGGTTAGGGTTAGGGTTAGGGTTAGGGTTAGGGTTAGGGTTAGGGTTAGGGTTA
scaffold_83 Fusarium odoratissimum isolate CF00141	forward	CCCTAACCCTAACCCTAACCCTAACCCTAACCCTAACCCTAACCCTAACCCTAACCCTAACCCTAACCCTAGCCCTAGCCCTAACGCTAACCCTAACCCT
scaffold_109 Fusarium odoratissimum isolate CF00141	forward	CTAACCCTAACCCTAACCCTAACCCTAACCCTAACCCTAACCCTAACCCTAACCCTAACCCTAACCCTAACCCTAAATTAAGATAATCTGATAAACTAAA
scaffold_123 Fusarium odoratissimum isolate CF00141	reverse	CGCTTTGGGTCAGGGTTAGGGTCAGGGTTAGGGTCAGGGTTAGGGTTAGGGTTAGGGTTAGGGTTAGGGTTAGGGTTAGGGTTAGGGTTAGGGTTAGGGT
scaffold_133 Fusarium odoratissimum isolate CF00141	forward	TAACCCTAACCCTAACCCTAACCCTAACCCTAACCCTAACCCTAACCCTAACCCTAACCCTAACCCTAACCCTAATCTTTATTTCTTATTATCTCTCTTA
scaffold_147 Fusarium odoratissimum isolate CF00141	forward	CCCTAACCCTAACCCTAACCCTAACCCTAACCCTAACCCTAACCCTAACCCTAACCCTAACCCTAACCCTAACCCTTACTTAACCCAGCGCTACCGCGCT
scaffold_150 Fusarium odoratissimum isolate CF00141	reverse	AGGCAGCTTATATAGAGGCATTCCTTAGGGTTAGGGTTAGGGTTAGGGTTAGGGTTAGGGTTAGGGTTAGGGTTAGGGTTAGGGTTAGGGTTAGGGTTAG
scaffold_156 Fusarium odoratissimum isolate CF00141	reverse	GGTCCGAGTCCGAGTCCGAGTCCAGGTTAGGGTTAGGGTTAGGGTTAGGGTTAGGGTTAGGGTTAGGGTTAGGGTTAGGGTTAGGGTTAGGGTTAGGGTT
scaffold_160 Fusarium odoratissimum isolate CF00141	forward	AACCCTAACCCTAACCCTAACCCTAACCCTAACCCTAACCCTAACCCTAACCCTAACCCTAACCCTAACCCTAAGATAAGATCAGCAAGCACATAGGTAA
scaffold_172 Fusarium odoratissimum isolate CF00141	forward	ACCCTAACCCTAACCCTAACCCTAACCCTAACCCTAACCCTAACCCTAACCCTAACCCTAACCCTAACCCTAACCCTGACCCTAACCCTAACCCTTCTAA

Telomeres found: 20 (12 forward, 8 reverse)
