scaffold_10 Fusarium odoratissimum isolate CF00160	forward	CCTAACCCTAACCCTAACCCTAACCCTAACCCTAACCCTAACCCTAACCCTAACCCTAACCCTAACCCTAACCCTAAGGAATGCCTCTATATAAGCTGCC
scaffold_12 Fusarium odoratissimum isolate CF00160	forward	ACCCTAACCCTAACCCTAACCCTAACCCTAACCCTAACCCTAACCCTAACCCTAACCCTAACCCTAACCCTAACCCTTTACTTTATTTCTTTATTTATAT
scaffold_23 Fusarium odoratissimum isolate CF00160	reverse	AGGAGATAAAAATAGGAAAGAGATAGGGTTAGGGTTAGGGTTAGGGTTAGGGTTAGGGTTAGGGTTAGGGTTAGGGTTAGGGTTAGGGTTAGGGTTAGGG
scaffold_28 Fusarium odoratissimum isolate CF00160	forward	ACCCTAACCCTAACCCTAACCCTAACCCTAACCCTAACCCTAACCCTAACCCTAACCCTAACCCTAACCCTAACCCTGACCCTAACCCTAACCCTTCTAA
scaffold_34 Fusarium odoratissimum isolate CF00160	reverse	GGTAGTTCCTGGAGCGTCGTGATCTTAGGGTTAGGGTTAGGGTTAGGGTTAGGGTTAGGGTTAGGGTTAGGGTTAGGGTTAGGGTTAGGGTTAGGGTTAG
scaffold_48 Fusarium odoratissimum isolate CF00160	reverse	AGCATAAACTAATGGGCTACCTACTTAGGGTTAGGGTTAGGGTTAGGGTTAGGGTTAGGGTTAGGGTTAGGGTTAGGGTTAGGGTTAGGGTTAGGGTTAG
scaffold_49 Fusarium odoratissimum isolate CF00160	reverse	TCAGTCCCGTATTTAAACGCTAATTTAGTTTATCAGATTATCTTAATTTAGGGTTAGGGTTAGGGTTAGGGTTAGGGTTAGGGTTAGGGTTAGGGTTAGG
scaffold_50 Fusarium odoratissimum isolate CF00160	forward	CCTAACCCTAACCCCAACCCTAACCCTAACCCTAACCCTAACCCTAACCCTAACCCTAACCCTAACCCTAACCCTAATCACACTGGGGTAAGCCACGTAG
scaffold_56 Fusarium odoratissimum isolate CF00160	forward	TAAATCCTTATATAAATAGCACCAGAGCAAGATAGCTATCCATAGCCTAATATAACCCTATCCTAACCCTAACCCTAGTACAACTTTCACATGTTAGCTT
scaffold_65 Fusarium odoratissimum isolate CF00160	forward	AACCCTAACCCTAACCCTAACCCTAACCCTAACCCTAACCCTAACCCTAACCCTAACCCTAACCCTAACCCTAATAATATTACCTTTCTTCCTTAACCTT
scaffold_74 Fusarium odoratissimum isolate CF00160	forward	TAACCCTAACCCTAACCCTAACCCTAACCCTAACCCTAACCCTAACCCTAACCCTAACCCTAACCCTAACCCTAACCTTAAGGTCAGGGGTTATTTAAAT
scaffold_86 Fusarium odoratissimum isolate CF00160	reverse	AAAGGTTAGTCTTTTTAACCTTGTAGGGTTAGGGTTAGGGTTAGGGTTAGGGTTAGGGTTAGGGTTAGGGTTAGGGTTAGGGTTAGGGTTAGGGTTAGGG
scaffold_115 Fusarium odoratissimum isolate CF00160	forward	CCCTAACCCTAACCCTAACCCTAACCCTAACCCTAACCCTAACCCTAACCCTAACCCTAACCCTAACCCTAGCCCTAGCCCTAACGCTAACCCTAACCCT
scaffold_134 Fusarium odoratissimum isolate CF00160	forward	ACCCTAACCCTAACCCTAACCCTAACCCTAACCCTAACCCTAACCCTAACCCTAACCCTAACCCTGACCCTAACCCTGACCCTAACCCTGACCCAAAGCG
scaffold_138 Fusarium odoratissimum isolate CF00160	reverse	AGCGCGGTAGCGCTGGGTTAAGTAAGGGTTAGGGTTAGGGTTAGGGTTAGGGTTAGGGTTAGGGTTAGGGTTAGGGTTAGGGTTAGGGTTAGGGTTAGGG
scaffold_141 Fusarium odoratissimum isolate CF00160	forward	TAACCCTAACCCTAACCCTAACCCTAACCCTAACCCTAACCCTAACCCTAACCCTAACCCTAACCCTAACCCTAATCTTTATTTCTTATTATCTCTCTTA
scaffold_142 Fusarium odoratissimum isolate CF00160	forward	CTAACCCTAACCCTAACCCTAACCCTAACCCTAACCCTAACCCTAACCCTAACCCTAACCCTAACCCTAACCCTAATAAAGCAGAGAAGTTCCTTAGATA
scaffold_145 Fusarium odoratissimum isolate CF00160	reverse	TTACCTATGTGCTTGCTGATCTTATCTTAGGGTTAGGGTTAGGGTTAGGGTTAGGGTTAGGGTTAGGGTTAGGGTTAGGGTTAGGGTTAGGGTTAGGGTT
scaffold_151 Fusarium odoratissimum isolate CF00160	reverse	GGCCAGGCAACGGTAATACTTCAGTTAGGGTTAGGGTTAGGGTTAGGGTTAGGGTTAGGGTTAGGGTTAGGGTTAGGGTTAGGGTTAGGGTTAGGGTTAG
scaffold_155 Fusarium odoratissimum isolate CF00160	forward	AACCCTAACCCTAACCCTAACCCTAACCCTAACCCTAACCCTAACCCTAACCCTAACCCTAACCCTAACCCTAACCTGGACTCGGACTCGGACTCGGACC

Telomeres found: 20 (12 forward, 8 reverse)
