scaffold_1	forward	ATCTTAGTTAGAGAAAAACACCAGGGCAAAGATAGCTTAGATAGTTAATACTAACCCTATCCTAACCCTAACCCTAAGAAAACAAGGAACTCTCGCAATT
scaffold_7	reverse	TTACAGAATATATAAGGTATTATATTAAGTAAGTTAGTTATTATATCTCTTAATAATTAAGTAATACTTATTAGGCTTATTAATATAAAGAAGTCTTATT
scaffold_8	reverse	TTACTATCCTCTTTAATTAGGGTTAGGGTTAGGATAGGGTTAGTATTAACTATCTAAGCTATCTTTGCCCTGGTGTTTTTCTCTAACTAAGATCTAGCTA
scaffold_9	forward	CTAACCCTAACCCTAACCCTAACCCTAACCCTAACCCTAACCCTAACCCTAACCCTAACCCTAACCCTAACCCTAACTATCTAAGTAATAGAAATAGTAC
scaffold_17	forward	CCTAACCCTAACCCTAACCCTAACCCTAACCCTAACCCTAACCCTAACCCTAACCCTAACCCTAACCCTAACCCTAGACCCTATAGGCCTTAAAGACCTC
scaffold_23	reverse	AATAAAGGGTTAGGGTTATAAAATATAAAGAGATTTAAGGTAAGGGTAAGAATAAATAGGTTAGGGTTTATAGAGTTTTAATAAGGATTAAGTAAGGGGA
scaffold_29	forward	CTAACCCTAACCCTAACCCTAACCCTAACCCTAACCCTAACCCTAACCCTAACCCTAACCCTAACCCTAACCCTAAGGGTGTCTGGAGACGATCTCATTA
scaffold_42	forward	CCTAACCCTAACCCTAACCCTAACCCTAACCCTAACCCTAACCCTAACCCTAACCCTAACCCTAACCCTAACCCTAATTTTCAAAATTTTTAAACCCTTA
scaffold_43	reverse	TCAACTTAGGGTTAGGGTCCGGGTTAGGGTTAGGGTTAGGATAGGGTTAGTATTAACTATCTAAGCTATCTTTGCCCTGGTGTTTTTCTCTAACTAAGAT
scaffold_45	reverse	ATAAGATAAATATATATATCTAAAAGGGTTAGGGTTAGGGTTAGGGTTAGGGTTAGGGTTAGGGTTAGGGTTAGGGTTAGGGTTAGGGTTAGGGTTAGGG
scaffold_47	forward	CCTAACCCTAACCCTAACCCTAACCCTAACCCTAACCCTAACCCTAACCCTAACCCTAACCCTAACCCTAACCCTAAAAAAGGCGCCTAAGTATATTACT
scaffold_48	forward	CTAACCCTAACCCTAACCCTAACCCTAACCCTAACCCTAACCCTAACCCTAACCCTAACCCTAACCCTAACCCTAGCGCCTATATATGCTAACTTTGATG
scaffold_49	forward	TAACCCTAACCCTAACCCTAACCCTAACCCTAACCCTAACCCTAACCCTAACCCTAACCCTAACCCTAACCCTAAGTTAGACTGGGTATTCGGCATTATA
scaffold_51	reverse	ATAAAACTACTACCAGATAAAAGCTTAGGGTTAGGGTTAGGGTTAGGGTTAGGGTTAGGGTTAGGGTTAGGGTTAGGGTTAGGGTTAGGGTTAGGGTTAG
scaffold_53	reverse	AAAGCTGGCAGTCTCTATTTCAGATTAGGGTTAGGGTTAGGGTTAGGGTTAGGGTTAGGGTTAGGGTTAGGGTTAGGGTTAGGGTTAGGGTTAGGGTTAG
scaffold_56	reverse	TACTCGATCGCCTCGCTGTGCAACCTTAGGGTTAGGGTTAGGGTTAGGGTTAGGGTTAGGGTTAGGGTTAGGGTTAGGGTTAGGGTTAGGGTTAGGGTTA
scaffold_69	forward	CCTAACCCTAACCCTAACCCTAACCCTAACCCTAACCCTAACCCTAACCCTAACCCTAACCCTAACCCTAACCCTAAGTAGGGATATTATTTAATATAGT
scaffold_71	reverse	TAGCTACTAGATAACCCTGGCCGAGGGTTAGGGTTAGGGTTAGGGTTAGGGTTAGGGTTAGGGTTAGGGTTAGGGTTAGGGTTAGGGTTAGGGTTAGGGT
scaffold_75	forward	CTAACCCTAACCCTAACCCTAACCCTAACCCTAACCCTAACCCTAACCCTAACCCTAACCCTAACCCTAACCCTAAGAATGTTGAGCTCTTTGCATAGTT
scaffold_78	reverse	CTAACCTTAAGCCTAACTTAACCTCTAACTTAGGGTTAGGGTTAGGGTTAGGGTTAGGGTTAGGGTTAGGGTTAGGGTTAGGGTTAGGGTTAGGGTTAGG
scaffold_82	forward	AACCCTAACCCTAACCCTAACCCTAACCCTAACCCTAACCCTAACCCTAACCCTAACCCTAACCCTAACCCTAACCCGGACCCTAACCCAACGTCTGACC
scaffold_91	forward	TAGCTATTAATAAGACTTCTTTATATTAATAAGCCTAATATGCATTACTTAATTATTAAGAGATATAATAACTAACCCGCTTAGTATTAATGCCTTATGC
scaffold_99	forward	TAACTAATATATAAGTAATAACTAACTATATAAAGTAGATAAGGCAGAGTTTATTTATATCTAACTAATATCTAAATGCTTTTTTACTATATTAAGAGGA
scaffold_99	reverse	TTTTTAGGGTTAGGGTTAGGATAGGGTTATATTAGGCTATGGAAAGCTATCTTGCTTAAGTGCTATTTATATAAGGATTTATAAAGAGTATAAAGGAGAG
scaffold_105	reverse	GCCTTTTAATTATATAGTAGTCCTTTGGGTTAGGGTTAGGGTTAGGGTTAGGGTTAGGGTTAGGGTTAGGGTTAGGGTTAGGGTTAGGGTTAGGGTTAGG

Telomeres found: 25 (13 forward, 12 reverse)
