scaffold_1	forward	ACCCTAACCCTAACCCTAACCCTAACCCTAACCCTAACCCTAACCCTAACCCTAACCCTAACCCTAACCCTAACCCTTTTAGATATATATATTTATCTTA
scaffold_2	forward	ATCTTAGTTAGAGAAAAACACCAGGGCAAAGATAGCTTAGATAGTTAATACTAACCCTATCCTAACCCTAACCCTAAGAAAACAAGGAACTCTCGCAATT
scaffold_3	reverse	ATACTATATTAAATAATATCCCTACTTAGGGTTAGGGTTAGGGTTAGGGTTAGGGTTAGGGTTAGGGTTAGGGTTAGGGTTAGGGTTAGGGTTAGGGTTA
scaffold_4	reverse	TCAAAGTTAGCATATATAGGCGCTAGGGTTAGGGTTAGGGTTAGGGTTAGGGTTAGGGTTAGGGTTAGGGTTAGGGTTAGGGTTAGGGTTAGGGTTAGGG
scaffold_5	reverse	CTTAAGCCTAACTTAACCTCTAACTTAGGGTTAGGGTTAGGGTTAGGGTTAGGGTTAGGGTTAGGGTTAGGGTTAGGGTTAGGGTTAGGGTTAGGGTTAG
scaffold_7	forward	ATCTTAGTTAGAGAAAAACACCAGGGCAAAGATAGCTTAGATAGTTAATACTAACCCTATCCTAACCCTAACCCTAACCCGGACCCTAACCCTAAGTTGA
scaffold_11	forward	CCTAACCCTAACCCTAACCCTAACCCTAACCCTAACCCTAACCCTAACCCTAACCCTAACCCTAACCCTAACCCTAGACCCTATAGGCCTTAAAGACCTC
scaffold_13	reverse	ATACTATAATGCCGAATACCCAGTCTAACTTAGGGTTAGGGTTAGGGTTAGGGTTAGGGTTAGGGTTAGGGTTAGGGTTAGGGTTAGGGTTAGGGTTAGG
scaffold_32	reverse	AAGCTGGCAGTCTCTATTTCAGATTAGGGTTAGGGTTAGGGTTAGGGTTAGGGTTAGGGTTAGGGTTAGGGTTAGGGTTAGGGTTAGGGTTAGGGTTAGG
scaffold_33	forward	CTAACCCTAACCCTAACCCTAACCCTAACCCTAACCCTAACCCTAACCCTAACCCTAACCCTAACCCTAACCCTAACTATCTAAGTAATAGAAATAGTAC
scaffold_39	forward	ATCTTAGTTAGAGAAAAACACCAGGGCAAAGATAGCTTAGATAGTTAATACTAACCCTATCCTAACCCTAACCCTAATTAAAGAGGATAGTAAGGGAAAG
scaffold_41	forward	CTAACCCTAACCCTAACCCTAACCCTAACCCTAACCCTAACCCTAACCCTAACCCTAACCCTAACCCTAACCCTAATTTTCAAAATTTTTAAACCCTTAC
scaffold_42	forward	CTAACCCTAACCCTAACCCTAACCCTAACCCTAACCCTAACCCTAACCCTAACCCTAACCCTAACCCTAACCCTAAGAATGTTGAGCTCTTTGCATAGTT
scaffold_43	forward	CTAACCCTAACCCTAACCCTAACCCTAACCCTAACCCTAACCCTAACCCTAACCCTAACCCTAACCCTAACCCTAAGCTTTTATCTGGTAGTAGTTTTAT
scaffold_45	reverse	TACTCGATCGCCTCGCTGTGCAACCTTAGGGTTAGGGTTAGGGTTAGGGTTAGGGTTAGGGTTAGGGTTAGGGTTAGGGTTAGGGTTAGGGTTAGGGTTA
scaffold_47	forward	CCTAACCCTAACCCTAACCCTAACCCTAACCCTAACCCTAACCCTAACCCTAACCCTAACCCTAACCCTAACCCTAAAAAAGGCGCCTAAGTATATTACT
scaffold_48	reverse	TAGCTACTAGATAACCCTGGCCGAGGGTTAGGGTTAGGGTTAGGGTTAGGGTTAGGGTTAGGGTTAGGGTTAGGGTTAGGGTTAGGGTTAGGGTTAGGGT
scaffold_53	reverse	ACGTTGGGTTAGGGTTAGGGTTAGGTTAGGGTTAGGGTTAGGGTTAGGGTTAGGGTTAGGGTTAGGGTTAGGGTTAGGGTTAGGGTTAGGGTTAGGGTTA
scaffold_58	reverse	GCCTTTTAATTATATAGTAGTCCTTTGGGTTAGGGTTAGGGTTAGGGTTAGGGTTAGGGTTAGGGTTAGGGTTAGGGTTAGGGTTAGGGTTAGGGTTAGG

Telomeres found: 19 (10 forward, 9 reverse)
