scaffold_1 Fusarium odoratissimum isolate CF00145	reverse	TAGCTACTAGATAACCCTGGCCGAGGGTTAGGGTTAGGGTTAGGGTTAGGGTTAGGGTTAGGGTTAGGGTTAGGGTTAGGGTTAGGGTTAGGGTTAGGGT
scaffold_5 Fusarium odoratissimum isolate CF00145	forward	AATAAGACTTCTTTATATTAATAAGCCTAATAAGTATTACTTAATTATTAAGAGATATAATAACTAACTTACTTAATATAATACCTTATATATTCTGTAA
scaffold_6 Fusarium odoratissimum isolate CF00145	reverse	TAAGATAAATATATATATCTAAAAGGGTTAGGGTTAGGGTTAGGGTTAGGGTTAGGGTTAGGGTTAGGGTTAGGGTTAGGGTTAGGGTTAGGGTTAGGGT
scaffold_8 Fusarium odoratissimum isolate CF00145	forward	TAGCTAGATCTTAGTTAGAGAAAAACACCAGGGCAAAGATAGCTTAGATAGTTAATACTAACCCTATCCTAACCCTAACCCTAATTAAAGAGGATAGTAA
scaffold_9 Fusarium odoratissimum isolate CF00145	forward	ATCTTAGTTAGAGAAAAACACCAGGGCAAAGATAGCTTAGATAGTTAATACTAACCCTATCCTAACCCTAACCCTAAGAAAACAAGGAACTCTCGCAATT
scaffold_10 Fusarium odoratissimum isolate CF00145	forward	ATCTTAGTTAGAGAAAAACACCAGGGCAAAGATAGCTTAGATAGTTAATACTAACCCTATCCTAACCCTAACCCTAACCCGGACCCTAACCCTAAGTTGA
scaffold_13 Fusarium odoratissimum isolate CF00145	forward	CCCTAACCCTAACCCTAACCCTAACCCTAACCCTAACCCTAACCCTAACCCTAACCCTAACCCTAACCCTAACCCTAAGAATGTTGAGCTCTTTGCATAG
scaffold_15 Fusarium odoratissimum isolate CF00145	forward	CTAACCCTAACCCTAACCCTAACCCTAACCCTAACCCTAACCCTAACCCTAACCCTAACCCTAACCCTAACCCTAAGGGTGTCTGGAGACGATCTCATTA
scaffold_17 Fusarium odoratissimum isolate CF00145	reverse	ATAAAACTACTACCAGATAAAAGCTTAGGGTTAGGGTTAGGGTTAGGGTTAGGGTTAGGGTTAGGGTTAGGGTTAGGGTTAGGGTTAGGGTTAGGGTTAG
scaffold_23 Fusarium odoratissimum isolate CF00145	forward	CCTAACCCTAACCCTAACCCTAACCCTAACCCTAACCCTAACCCTAACCCTAACCCTAACCCTAACCCTAACCCTAGACCCTATAGGCCTTAAAGACCTC
scaffold_25 Fusarium odoratissimum isolate CF00145	reverse	AAGCTGGCAGTCTCTATTTCAGATTAGGGTTAGGGTTAGGGTTAGGGTTAGGGTTAGGGTTAGGGTTAGGGTTAGGGTTAGGGTTAGGGTTAGGGTTAGG
scaffold_27 Fusarium odoratissimum isolate CF00145	reverse	GTACTATTTCTATTACTTAGATAGTTAGGGTTAGGGTTAGGGTTAGGGTTAGGGTTAGGGTTAGGGTTAGGGTTAGGGTTAGGGTTAGGGTTAGGGTTAG
scaffold_33 Fusarium odoratissimum isolate CF00145	forward	CTAACCCTAACCCTAACCCTAACCCTAACCCTAACCCTAACCCTAACCCTAACCCTAACCCTAACCCTAACCCTAATTTTCAAAATTTTTAAACCCTTAC
scaffold_34 Fusarium odoratissimum isolate CF00145	forward	CTAACCCTAACCCTAACCCTAACCCTAACCCTAACCCTAACCCTAACCCTAACCCTAACCCTAACCCTAACCCTAAGTTAGACTGGGTATTCGGCATTAT
scaffold_37 Fusarium odoratissimum isolate CF00145	reverse	TACTCGATCGCCTCGCTGTGCAACCTTAGGGTTAGGGTTAGGGTTAGGGTTAGGGTTAGGGTTAGGGTTAGGGTTAGGGTTAGGGTTAGGGTTAGGGTTA
scaffold_40 Fusarium odoratissimum isolate CF00145	forward	TAACCCTAACCCTAACCCTAACCCTAACCCTAACCCTAACCCTAACCCTAACCCTAACCCTAACCCTAACCCTAAGTAGGGATATTATTTAATATAGTAT
scaffold_41 Fusarium odoratissimum isolate CF00145	forward	CTAACCCTAACCCTAACCCTAACCCTAACCCTAACCCTAACCCTAACCCTAACCCTAACCCTAACCCTAACCCTAGCGCCTATATATGCTAACTTTGATG
scaffold_42 Fusarium odoratissimum isolate CF00145	reverse	ATACTTAGGCGCCTTTTTTAGGGTTAGGGTTAGGGTTAGGGTTAGGGTTAGGGTTAGGGTTAGGGTTAGGGTTAGGGTTAGGGTTAGGGTTAGGGTTAGG
scaffold_47 Fusarium odoratissimum isolate CF00145	forward	CCTAACCCTAACCCTAACCCTAACCCTAACCCTAACCCTAACCCTAACCCTAACCCTAACCCTAACCCTAAGTTAGAGGTTAAGTTAGGCTTAAGGTTAG
scaffold_52 Fusarium odoratissimum isolate CF00145	forward	AACCCTAACCCTAACCCTAACCCTAACCCTAACCCTAACCCTAACCCTAACCCTAACCCTAACCCTAACCCTAACCCGGACCCTAACCCAACGTCTGACC
scaffold_58 Fusarium odoratissimum isolate CF00145	reverse	TTTATATTAGGCATAGTTTATAAAGTTAAAATATATAGTTAAGTTAGTTAAATTAATAGTATAAATATTCTATTATAAGAATTAAGGGCTATTATAGGGT
scaffold_61 Fusarium odoratissimum isolate CF00145	reverse	GCCTTTTAATTATATAGTAGTCCTTTGGGTTAGGGTTAGGGTTAGGGTTAGGGTTAGGGTTAGGGTTAGGGTTAGGGTTAGGGTTAGGGTTAGGGTTAGG

Telomeres found: 22 (13 forward, 9 reverse)
