scaffold_3	reverse	AGGGTTAGGGTTAGGGTTAGGGTTAGGGTTAGGGTTAGGGTTAGGGTTAGGGTTAGGGTTAGGGTTAGGGTTAGGGTTAGGGTTAGGGTTAGGGTTAGGG
scaffold_6	forward	CCTAACCCTAACCCTAACCCTAACCCTAACCCTAACCCTAACCCTAACCCTAACCCTAACCCTAACCCTAACCCTAAGTCCCTTTAGCCTCCAACTCGAA
scaffold_8	forward	TAACCCTAACCCTAACCCTAACCCTAACCCTAACCCTAACCCTAACCCTAACCCTAACCCTAACCCTAACCCTAAGTTGAATAAGACAATGTAATAAGAT
scaffold_11	forward	AACCCTAACCCTAACCCTAACCCTAACCCTAACCCTAACCCTAACCCTAACCCTAACCCTAACCCTAACCCTAACCCTAACCCTAACCCTCGCCTATTAT
scaffold_11	reverse	AGGCAGAGAGATTTTATATTATTTAGTTAGTTATATAAGCTATTTATTCAAAATAGAGTTAATTAAAGCAGCTATAAGGTTATATAATATAGCTAAAAGG
scaffold_16	forward	ACCCTAACCCTAACCCTAACCCTAACCCTAACCCTAACCCTAACCCTAACCCTAACCCTAACCCTAACCCTAACCCTGACCCTAGTCAGAAATGGCTTAT
scaffold_18	reverse	TAAGTAATTATTATAATAAATGCACTTAGGGTTAGGGTTAGGGTTAGGGTTAGGGTTAGGGTTAGGGTTAGGGTTAGGGTTAGGGTTAGGGTTAGGGTTA
scaffold_23	forward	CTAACCCTAACCCTAACCCTAACCCTAACCCTAACCCTAACCCTAACCCTAACCCTAACCCTAACCCTAACCCTAAGCGACGCTATCTCGCCGATTTGGA
scaffold_25	forward	TAACCCTAACCCTAACCCTAACCCTAACCCTAACCCTAACCCTAACCCTAACCCTAACCCTAACCCTAACCCTAACCATAACCCTAACCCTAACCCTGAG
scaffold_26	reverse	ACTTTTGGTTAAATCCTGGGTCAGCTTAGGGTTAGGGTTAGGGTTAGGGTTAGGGTTAGGGTTAGGGTTAGGGTTAGGGTTAGGGTTAGGGTTAGGGTTA
scaffold_27	forward	TAACCCTAACCCTAACCCTAACCCTAACCCTAACCCTAACCCTAACCCTAACCCTAACCCTAACCCTAACCCTAAGTAATCAGATCGAGCTTTTCCATGA
scaffold_29	forward	AACCCTAACCCTAACCCTAACCCTAACCCTAACCCTAACCCTAACCCTAACCCTAACCCTAACCCTAACCCTAAGCGTGCTGGGTGCTGTGACGTTTACC
scaffold_31	forward	CTAACCCTAACCCTAACCCTAACCCTAACCCTAACCCTAACCCTAACCCTAACCCTAACCCTAACCCTAACCCTAAGATATTAGGGTTAAAAATCTACTT
scaffold_35	reverse	AAATAAATAAATAAATAAATAAATAGGGTTAGGGTTAGGGTTAGGGTTAGGGTTAGGGTTAGGGTTAGGGTTAGGGTTAGGGTTAGGGTTAGGGTTAGGG
scaffold_37	forward	AACCCTAACCCTAACCCTAACCCTAACCCTAACCCTAACCCTAACCCTAACCCTAACCCTAACCCTAACCCTAAGAACCTCTCCGTGCAAGCTGCCTCGG
scaffold_41	reverse	ACATGTCACAAGTATATGCTGTGGCTTAGGGTTAGGGTTAGGGTTAGGGTTAGGGTTAGGGTTAGGGTTAGGGTTAGGGTTAGGGTTAGGGTTAGGGTTA
scaffold_43	reverse	TATATTACCCCATGAAGGCTCTTATAGGGTTAGGGTTAGGGTTAGGGTTAGGGTTAGGGTTAGGGTTAGGGTTAGGGTTAGGGTTAGGGTTAGGGTTAGG
scaffold_44	reverse	CAATGAGAGAGTGAGCCCAAGGATTAGGGTTAGGGTTAGGGTTAGGGTTAGGGTTAGGGTTAGGGTTAGGGTTAGGGTTAGGGTTAGGGTTAGGGTTAGG
scaffold_45	reverse	AGGCAAAGAACTGCCCAAGAGCAGACTTAGGGTTAGGGTTAGGGTTAGGGTTAGGGTTAGGGTTAGGGTTAGGGTTAGGGTTAGGGTTAGGGTTAGGGTT
scaffold_47	forward	CTAACCCTAACCCTAACCCTAACCCTAACCCTAACCCTAACCCTAACCCTAACCCTAACCCTAACCCTAACCCTAAGGCGCCGGCTCTCCTCCCGTCGTT
scaffold_48	reverse	AGTTAGTTAGCACAAAGCCATCGACGCAAAAATGTGATTCCGCCCGGGCTCGAACCGGGGACCTTCTCGGTGTTAACGAGATGCCATAACCAGCTAGACC
scaffold_52	forward	TAACTTAATACTTAGGTTAATAGCTTAGTAACTTAAATTAATAAAATTACTTTTAATTATAGCTATAATAATACTACCTTAACTAACTCTATTAAAAGTA
scaffold_53	forward	TAACCCTAACCCTAACCCTAACCCTAACCCTAACCCTAACCCTAACCCTAACCCTAACCCTAACCCTAACCCTAAGAAAAAGATAATTCGGGGATAGATA
scaffold_54	reverse	AAAGCTAGCGCCTATTATTTATAAGGGTTAGGGTTAGGGTTAGGGTTAGGGTTAGGGTTAGGGTTAGGGTTAGGGTTAGGGTTAGGGTTAGGGTTAGGGT
scaffold_58	forward	AACCCTAACCCTAACCCTAACCCTAACCCTAACCCTAACCCTAACCCTAACCCTAACCCTAACCCTAACCCTAAGAAGCCCTAATGGCGGTGCTCTAGAA
scaffold_60	forward	CCTAACCCTAACCCTAACCCTAACCCTAACCCTAACCCTAACCCTAACCCTAACCCTAACCCTAACCCTAACCCTTACCCTTTTTTATCTTAATAAGCCT
scaffold_60	reverse	ATAGTATTATTAGCTTACTTCTTAACTTAGGGTTAGGGTTAGGGTTAGGGTTAGGGTTAGGGTTAGGGTTAGGGTTAGGGTTAGGGTTAGGGTTAGGGTT
scaffold_66	reverse	GGGTTAGGGTTAGGGTTAGGGTTAGGGTTAGGGTTAGGGTTAGGGTTAGGGTTAGGGTTAGGGTTAGGGTTAGGGTTAGGGTTAGGGTTAGGGTTAGGGT
scaffold_70	reverse	GCCTGGCAGCCGCAGCTAGACCGACGCTTAGGGTTAGGGTTAGGGTTAGGGTTAGGGTTAGGGTTAGGGTTAGGGTTAGGGTTAGGGTTAGGGTTAGGGT
scaffold_71	forward	TTAAGCCTAGGTTAAGTTATTAATATATTATATTAATAAGATTACCTTTTAGCTATATTATATAACCTTATAGCTGCTTTAACTAACTCTATTTTAAATA
scaffold_74	reverse	GAAATTTTAAGATAGGCTGGACGATAGGGTTAGGGTTAGGGTTAGGGTTAGGGTTAGGGTTAGGGTTAGGGTTAGGGTTAGGGTTAGGGTTAGGGTTAGG
scaffold_78	reverse	TACAAGTTATTTATTTAGAATAAAGTTAGTTAAGGCAGCTATAAGGTTATATAATATAGCTAAAAAGTAACCTTATTAATATAATATATTAATAACTTAA
scaffold_80	forward	CCCTAACCCTAACCCTAACCCTAACCCTAACCCTAACCCTAACCCTAACCCTAACCCTAACCCTAACCCTGACCCTAACCCTAACCCTAACCCTAAAAAA
scaffold_83	reverse	CTTAGGGTTAGGTAGGAAGACTAGGTTAGGGTTAGGGTTAGGGTTAGGGTTAGGGTTAGGGTTAGGGTTAGGGTTAGGGTTAGGGTTAGGGTTAGGGTTA

Telomeres found: 34 (17 forward, 17 reverse)
